10
10
# # # . . . . . . . 
# . . . . . . . # # 
. . . . . . . . # . 
. . . # # # # + # . 
. . . . . . # . < . 
# # # # # / # # # # 
. + . # . . . . . . 
. # $ # . . . . . . 
. # # # . . . . . . 
. . . . . . . . . . 
