10
10
. . . . . . . . . .
. . < . . . . . . .
. . . . . . # # + #
. . # . . . # . . #
# + # . . . # . > #
# . . . . . # . . .
# . . . . . # . . .
# . . . . . # . . .
# . . . . . . # / #
# # # . . . . . . .