10
10
. . . . . . . . . .
. . . . . . . . # .
# . . . . . . . # .
# . . . . . . . / .
# # # # / # . # # .
. . . . . # . . . .
. . . . . # . . . .
. # # + # # . . . .
. . > . . . . . . .
. . . . . . . . . .