10
10
. . . . . . . . . . 
. . > . . . . . # . 
# . . . . . . . # . 
# . . . . . . . / . 
# # # # / # . # # . 
. . . . . # . . . . 
. . . . . # . . . . 
. # # + # # . . . . 
. . . . . . . . . . 
. . . . . . . . . . 
