6
6
. . . . . .
# . > . . #
# . . / . .
. + . . . .
# # # . / #
. . . . . .