10
10
. . . . . . . . . .
. . . . . . . . . .
. . . . . . # # / #
. . # . . . # . . #
# + # . . . # . > #
# . . . . . # . . .
# . . . . . # . . .
# . . . . . # . . .
# . < . . . . # + #
# # # . . . . . . .